111111111111111
10000P000000001
10000E0000C0001
1000010000C0001
1000010000C0001
111111111111111